R 641 481
NO ./textures/brick.xpm
SO ./textures/floor.xpm
WE ./textures/eagle.xpm
EA ./textures/door.xpm

F 128, 43, 0
C 0, 204, 153

 1111111111111
 1000000000001
11110000001111
1000000000011
100000S000001
1000000000011
1000010100001
1111111111111