R 1000 1000
NO ./textures/wood.xpm
SO ./textures/banner.xpm
WE ./textures/blue.xpm
EA ./textures/grey.xpm

F 128, 43, 0
C 0, 204, 153

1111111111111
100000000000111111111111111111111111111111111
100000000000000000000000000000000000000000001
100000W00000111111111111111111111111111111111
1000000000011            10001          
1000010100001            11111       
1111111111111 