R  1280 720
NO ./textures/brick.xpm   
SO ./textures/blue.xpm
WE ./textures/wood.xpm
EA ./textures/grey.xpm

F 0,0,0
C 255,255,255

1111111111111111111111111111111
1110000000000000000000000000001
111000000N000001111111111111111
1110000000000001
1010000000000001
1000000001111111
1111000000000001
1111111111111111